===========================================================================================
=  ========        ==  ====  ==        ==  =============        ==  ====  ====  ====    ===
=  ========  ========  ====  ==  ========  ================  =====  ====  ====  ===  ==  ==
=  ========  ========  ====  ==  ========  ================  =====  ====  ====  ==  ====  =
=  ========  ========  ====  ==  ========  ================  =====  ====  ====  ==  ====  =
=  ========      ====   ==   ==      ====  ================  =====   ==    ==  ===  ====  =
=  ========  =========  ==  ===  ========  ================  ======  ==    ==  ===  ====  =
=  ========  =========  ==  ===  ========  ================  ======  ==    ==  ===  ====  =
=  ========  ==========    ====  ========  ================  =======    ==    =====  ==  ==
=        ==        =====  =====        ==        ==========  ========  ====  =======    ===
===========================================================================================


