========================================================================================
=  ========        ==  ====  ==        ==  ===============    ====  =======  ==        =
=  ========  ========  ====  ==  ========  ==============  ==  ===   ======  ==  =======
=  ========  ========  ====  ==  ========  =============  ====  ==    =====  ==  =======
=  ========  ========  ====  ==  ========  =============  ====  ==  ==  ===  ==  =======
=  ========      ====   ==   ==      ====  =============  ====  ==  ===  ==  ==      ===
=  ========  =========  ==  ===  ========  =============  ====  ==  ====  =  ==  =======
=  ========  =========  ==  ===  ========  =============  ====  ==  =====    ==  =======
=  ========  ==========    ====  ========  ==============  ==  ===  ======   ==  =======
=        ==        =====  =====        ==        =========    ====  =======  ==        =
========================================================================================


