=========================================================================================================
=  ========        ==  ====  ==        ==  =============        ==  ====  ==       ===        ==        =
=  ========  ========  ====  ==  ========  ================  =====  ====  ==  ====  ==  ========  =======
=  ========  ========  ====  ==  ========  ================  =====  ====  ==  ====  ==  ========  =======
=  ========  ========  ====  ==  ========  ================  =====  ====  ==  ===   ==  ========  =======
=  ========      ====   ==   ==      ====  ================  =====        ==      ====      ====      ===
=  ========  =========  ==  ===  ========  ================  =====  ====  ==  ====  ==  ========  =======
=  ========  =========  ==  ===  ========  ================  =====  ====  ==  ====  ==  ========  =======
=  ========  ==========    ====  ========  ================  =====  ====  ==  ====  ==  ========  =======
=        ==        =====  =====        ==        ==========  =====  ====  ==  ====  ==        ==        =
=========================================================================================================


